1111111111111111111111111111111111111111111111111111111111111111111111111111111111111111111111111111
1111111111111111111111111111111111111111111111111111111111111111111111111111111111111111111111111111
1111111111111111111111111111111111111111111111111111111111111111111111111111111111111111111111111111
1000000000000000011111111111111111111111111111111111111111111111111111111111111111111111111111111111
1000000000000000011111111111111111111111111111111111111111111111111111111111111111111111111111111111
1000000000000000011111111111111111111111111111111111111111111111111111111111111111111111111111111111
1000000001111110011111111111111111111111111111111111111111111111111111111111111111111111111111111111
1000000001111110011111111111111111111111111111111111111111111111111111111111111111111111111111111111
1111111111111110011111111111111111111111111111111111111111111111111111111111111111111111111111111111
1111111111111110011111111111111111111111111111111111111111111111111111111111111111111111111111111111
1111111111111110011111111111111111111111111111111111111111111111111111111111111111111111111111111111
1111111111111000000111111111111111111111111111111111111111111111111111111111111111111111111111111111
1111111111111000000111111111111111111111111111111111111111111111111111111111111111111111111111111111
1111111111111000000111111111111111111111111111111111111111111111111111111111111111111111111111111111
1111111111111000000111111111111110000000011111111111111111111111111111111111111111111111111111111111
1111111111111000000111111111111110000000011111111111111111111111111111111111111111111111111111111111
1111111111111000000111111111111110000000011111111111111111111111111111111111111111111111111111111111
1111111111111000000111111111111110000000011111111111111111111111111111111111111111111111111111111111
1111111111111000000000000000000000000000011111111111111111111111111111111111111111111111111111111111
1111111000000000000000000000000000000000011111111111111111111111111111111111111111111111111111111111
1111111000000000000011111111111110000000011111111111111111111111111111111111111111111111111111111111
1111111001110000000011111111111110000000011111111111111111111111111111111111111111111111111111111111
1111111001110000000011111111111110000000011111111111111111111111111111111111111111111111111111111111
1111111001110000000011111111111110000000011111111111111111111111111111111111111111111111111111111111
1111111001110000000000000000000000000000000000000000001111111111111111111111111111111111111111111111
1111111001110000000000000000000000000000000000000000001111111111111111111111111111111111111111111111
1111111001110000000011111111111111111111111111111111001111111111111111111111111111111111111111111111
1111111001110000000011111111111100000011111111111111001111111111111111111111111111111111111111111111
1111111001110000000011111111111100000011111111111111001111111111111111111111111111111111111111111111
1111111001110000000011111111111100000011111111111111001111111111111111111111111111111111111111111111
1111111001110000000011111111111100000011111000000000001111111111111111111111111111111111111111111111
1111111001111111111111111111111100000011111000000000001111111111111111111111111111111111111111111111
1111111001111111111111111111111100000011111000000000001111111111111111111111111111111111111111111111
1111111001111111111111111111111100000000000000000000001111111111111111111111111111111111111111111111
1111111001111111111111111111111100000000000000000000001111111111111111111111111111111111111111111111
1111111000000000001111111111111100000011111000000000001111111111111111111111111111111111111111111111
1111111000000000001111111111111100000011111000000000001111111111111111111111111111111111111111111111
1111111000000000001111111111111111100111111000000000001111111111111111111111111111111111111111111111
1111111100000000001111111111111111100111111000000000001111111111111111111111111111111111111111111111
1111111100000000000000000000000000000000000000000000001111111110000000000111111111111111111111111111
1111111100000000000000000000000000000000000000010000011111111110000000000111111111111111111111111111
1111111100000000001111111111111111100111111111110000011111111110000000000111111111111111111111111111
1111111100000000001111111111111111100111111111110000011111111110000000000111111111111111111111111111
1111111100111111111111111111111111100100000000000000000000000000000000000111111111111111111111111111
1111111100111111111111111111111111100100000000000000000000000000000000000111111111111111111111111111
1111111100111111111111111111111111100100111111110010011111111110000000000111111111111111111111111111
1111111100111111111111111111111111100100111111110010011111111110000000000111111111111111111111111111
1111111100111111111111111111111111100100111111110010011111111110000000000111111111111111111111111111
1111111100111111111111111111111111100100111111110010011111111110000000000111111111111111111111111111
1111111100111111111111111111111111100100111111110010011111111111111001111111111111111111111111111111
1111111100111111111111111111111111100100111111110010011111111111111001111111111111111111111111111111
1111111100111111111111111111111111100100111111110010011111111111111001111111111111111111111111111111
1111111100111111111111111111111111100100111110000000000001111111111001111111111111111111111111111111
1111111100111111111111111111111111100100111110000000000001111111111001111111111111111111111111111111
1111111100111111111111111111111111100000011110000000000001111111111001111111111111111111111111111111
1111111100111111111111111111111111100000011110000000000001111111111001111111111111111111111111111111
1111111100111111111111111111111111100000011110000000000001111111111001111111111111111111111111111111
1111111100111111111111111111111111100000011110000000000001111111111001111111111111111111111111111111
1111111100111111111111111111111111100000011111111110011111111111111001111111111111111111111111111111
1111111100111111111111111111111111100000011111111110011111111111111001111111111111111111111111111111
1111111100111111111111111111111111100000011111111110011111111111111001111111111111111111111111111111
1111111100111111111111111111111111100000011111111110011111111111111001111111111111111111111111111111
1111111100111111111111111111111111111111111111111110011111111111111001111111111111111111111111111111
1111111100111111111111111111111111111111111111111110011111111111111001111111111111111111111111111111
1111111100111111111111111111111111111111111111111110011111111111111001111111111111111111111111111111
1111111100111111111111111111111111111111111111111110011111111111111001111111111111111111111111111111
1111111100111111111111111111111111111111111111111110011111111111111001111111111111111111111111111111
1111111100111111111111111111111111111111111111111110011111111111111001111111111111111111111111111111
1111111100111111111111111111111111111111111111100000000000111111111001111111111111111111111111111111
1111111100111111111111111111111111111111111111100000000000111111111001111111111111111111111111111111
1111111100111111111111111111111111111111111111100000000000111111111001111111111111111111111111111111
1111111100111111111111111111111111111111111111100000000000111111111001111111111111111111111111111111
1111111100111111111111111111111111111111111111100000000000111111111001111111111111111111111111111111
1111111100111111111111111111111111111111111111100000000000111111111001111111111111111111111111111111
1111111100111111111111111111111111111111111111100000000000111111111001111111111111111111111111111111
1111111100111111111111111111111111111111111111100000000000111111111001111111111111111111111111111111
1111111100111111111111111111111111111111111111100000000000111111111001111111111111111111111111111111
1111111100111111111111111111111111111111111111100000000000111111111001111111111111111111111111111111
1111111100111111111111111111111111111111111111111111111111111111111001111111111111111111111111111111
1111111100111111111111111111111111111111111111111111111111111111111001111111111111111111111111111111
1111111100111111111111111111111111111111111111111111111111111111111001111111111111111111111111111111
1111111100111111111111111111111111111111111111111111111111111111111001111111111111111111111111111111
1111111100111111111111111111111111111111111111111111111111111111111001111111111111111111111111111111
1111111100111111111111111111111111111111111111111111111111111111111001111111111111111111111111111111
1111111100111111111111111111111111111111111111111111111111111111111001111111111111111111111111111111
1111111100111111111111111111111111111111111111111111111111111111111001111111111111111111111111111111
1111111100111111111111111111111111111111111111111111111111111111111001111111111111111111111111111111
1111111100111111111111111111111111111111111111111111111111111111111001111111111111111111111111111111
1111100000001111111111111111111111111111111111111111111111111111111001111111111111111111111111111111
1111100000001111111111111111111111111111111111111111111111111111111001111111111111111111111111111111
1111100000000000000000000000000000000000000000000000000000000000000001111111111111111111111111111111
1111100000000000000000000000000000000000000000000000000000000000000001111111111111111111111111111111
1111100000001111111111111111111111111111111111111111111111111111111111111111111111111111111111111111
1111100000001111111111111111111111111111111111111111111111111111111111111111111111111111111111111111
1111111111111111111111111111111111111111111111111111111111111111111111111111111111111111111111111111
1111111111111111111111111111111111111111111111111111111111111111111111111111111111111111111111111111
1111111111111111111111111111111111111111111111111111111111111111111111111111111111111111111111111111
1111111111111111111111111111111111111111111111111111111111111111111111111111111111111111111111111111
1111111111111111111111111111111111111111111111111111111111111111111111111111111111111111111111111111
1111111111111111111111111111111111111111111111111111111111111111111111111111111111111111111111111111
