1111111111111111111111111111111111111111111111111111111111111111111111111111111111111111111111111111
1111111111111111111111111111111111111111111111111111111111111111111111111111111111111111111111111111
1111111111111111111111111111111111111111111111111111111111111111111111111111111111111111111111111111
1000000000000000000011111111111111111111111111111111111111111111111111111111111111111111111111111111
1000000000000000000011111111111111111111111111111111111111111111111111111111111111111111111111111111
1000000000000000000011111111111111111111111111111111111111111111111111111111111111111111111111111111
1000000000000000000011111111111111111111111111111111111111111111111111111111111111111111111111111111
1000000000000000000011111111111111111111111111111111111111111111111111111111111111111111111111111111
1111111111111111110011111111111111111111111111111111111111111111111111111111111111111111111111111111
1111111111111111110011111111111111111111111111111111111111111111111111111111111111111111111111111111
1111111111111111110011111111111111111111111111111111111111111111111111111111111111111111111111111111
1111111111111111110011111111111111111111111111111111111111111111111111111111111111111111111111111111
1111111111111111110011111111111111111111111111111111111111111111111111111111111111111111111111111111
1111111111111111110011111111111111111111111111111111111111111111111111110000000000000111111111111111
1111111111111111110011111111111111111111111111111111111111111111111111110000000000000111111111111111
1111111111111111110011111111111111111111111111111100000000000000000111110000000000000111000000000001
1111111111111111110011111111111111111111111111111100000000000000000111110000000000000111000000000001
1111111111111111110011111111111111111111111111111100000000000000000111110000000000000111000000000001
1111111111111111110011111111111111000000000000000000000000000000000111110000000000000111000000000001
1111111111111111110011111111111111000000000000000000000000000000000111110000000000000111000000000001
1111111111111110000000000000000000000000000000000000000000000000000111110000000000000111000000000001
1111111111111110000000000000000000000000000000000000000000000000000000000000000000000111000000000001
1111111111100000000000011111111111000000000000000000000000000000000000000000000000000111000000000001
1111111111100000000000011111111111000000000000000000000000000000000000000000000000000111000000000001
1111111111100000000000010000000000000000000000000000000000000000000000000000000000000000000000000001
1111111111100000000000010000000000000000000000000000000000000000000000000000000000000000000000000001
1111111111100000000000010000000000000000000000000001111111100110000000000000000011111111000000000001
1111111111100000000000010000000000000000000000000001111111100110000000000000000011111111000000000001
1111111111100000000000010000000000000000000000000001111111100110000000000000000011111111000000000001
1111111111100000000000010000000000000000000000000001111111100110000000000000000111111111000000000001
1111111111100000000000000000000000000111111111111111111111100110000000000000011111111111000000000001
1111111100000000000000000000000000000111111111111111111111100110000000000000011111111111000000000001
1111111100000000000000010000000000000111111111111111111111100110000000000000011111111111000000000001
1111111100000000000000010000000000000111111111111111111111100110000000000000011111111111111110011111
1111111100000000000000011111111111111111111111111111111111100110000000000000011111111111111110011111
1111111100000000000000011111111111111111111111111111111111100111111111111111111111111111111110011111
1111111100000000000000011111111111111111111111111111111111100111111111111111111111111111111110011111
1111111100000000000000001111111111111111111111111111111111100111111111111111111111111111111110011111
1111111100000000000000000000000000000000000000000000000000000000000000000000000000000000000000011111
1111111100000000000000000000000000000000000000000000000000000000000000000000000000000000000000111111
1111111100000000000000001111111111111111111111111111111111100111111111111111111111111111111111111111
1111111100000000000000001111111111111111111111111111111111100111111111111111111111111111111111111111
1111111100000000000000001111111111111111111111111111111111100111111111111111111111111111111111111111
1111111100000000000000001111111111111111111111111111111111100111111111111111111111111111111111111111
1111111100000000000000001111111111111111111111111111111111100111111111111111111111111111111111111111
1111111110000000000000001111111111111111111111111111111111100111111111111111111111111111111111111111
1111111110000000000000001111111111111111111111111111111111100111111111111111111111111111111111111111
1111111110000000000000001111111111111111111111111111111111100111111111111111111111111111111111111111
1111111111111111001111111111111111111111111111111111111111100111111111111111111111111111111111111111
1111111111111111001111111111111111111111111111111111111111100111111111111111111111111111111111111111
1111111111111111001111111111111111111111111111111111111111100111111111111111111111111111111111111111
1111111111111111001111111111111111111111111111111111111111100111111111111111111111111111111111111111
1111111111111111001111111111111111111111111111111111111111100111111111111111111111111111111111111111
1111111111111111001111111111111111111111111111111111111111100111111111111111111111111111111111111111
1111111111111111001111111111111111111111111111111111111111100111111111111111111111111111111111111111
1111111111111111001111111111111111111111111111111111111111100111111111111111111111111111111111111111
1111111111111111001111111111111111111111111111111111111111100111111111111111111111111111111111111111
1111111111111111001111111111111111111111111111111111111111100111111111111111111111111111111111111111
1111111111111111001111111111111111111111111111111111111111100111111111111111111111111111111111111111
1111111111111111001111111111111111111111111111111111111111100111111111111111111111111111111111111111
1111111111111111001111111111111111111111111111111111111111100111111111111111111111111111111111111111
1111111111111111001111111111111111111111111111111111111111100111111111111111111111111111111111111111
1111111111111111001111111111111111111111111111111111111111100111111111111111111111111111111111111111
1111111111111111001111111111111111111111111111111111111111100111111111111111111111111111111111111111
1111111111111111001111111111111111111111111111111111111111100111111111111111111111111111111111111111
1111111111111111001111111111111111111111111111111111111111100111111111111111111111111111111111111111
1111111111111111001111111111111111111111111111111111111111100111111111111111111111111111111111111111
1111111111111111001111111111111111111111111111111111111111100111111111111111111111111111111111111111
1111111111111111001111111111111111111111111111111111111111100111111111111111111111111111111111111111
1111111111111111001111111111111111111111111111111111111111100111111111111111111111111111111111111111
1111111111111111001111111111111111111111111111111111111111100111111111111111111111111111111111111111
1111111111111111001111111111111111111111111111111111111111100111111111111111111111111111111111111111
1111111111111111001111111111111111111111111111111111111111100111111111111111111111111111111111111111
1111111111111111001111111111111111111111111111111111111111100111111111111111111111111111111111111111
1111111111111111001111111111111111111111111111111110000000000000000011111111111111111111111111111111
1111111111111111001111111111111111111111111111111110000000000000000011111111111111111111111111111111
1111111111111111001111111111111111111111111111111110000000000000000011111111111111111111111111111111
1111111111111111001111111111111111111111111111111110000000000000000011111111111111111111111111111111
1111111111111111001111111111111111111111111111111110000000000000000011111111111111111111111111111111
1111111111111111001111111111111111111111111111111110000000000000000011111111111111111111111111111111
1111111111111111001111111111111111111111111111111110000000000000000011111111111111111111111111111111
1111111111111111001111111111111111111111111111111110000000000000000011111111111111111111111111111111
1111111111111111000000000000000000000000000000000000000000000000000011111111111111111111111111111111
1111111111111111000000000000000000000000000000000000000000000000000011111111111111111111111111111111
1111111111111111111111111111111111111111111111111110000000000000000011111111111111111111111111111111
1111111111111111111111111111111111111111111111111110000000000000000011111111111111111111111111111111
1111111111111111111111111111111111111111111111111110000000000000000011111111111111111111111111111111
1111111111111111111111111111111111111111111111111110000000000000000011111111111111111111111111111111
1111111111111111111111111111111111111111111111111110000000000000000011111111111111111111111111111111
1111111111111111111111111111111111111111111111111110000000000000000011111111111111111111111111111111
1111111111111111111111111111111111111111111111111110000000000000000011111111111111111111111111111111
1111111111111111111111111111111111111111111111111111111111111111111111111111111111111111111111111111
1111111111111111111111111111111111111111111111111111111111111111111111111111111111111111111111111111
1111111111111111111111111111111111111111111111111111111111111111111111111111111111111111111111111111
1111111111111111111111111111111111111111111111111111111111111111111111111111111111111111111111111111
1111111111111111111111111111111111111111111111111111111111111111111111111111111111111111111111111111
1111111111111111111111111111111111111111111111111111111111111111111111111111111111111111111111111111
1111111111111111111111111111111111111111111111111111111111111111111111111111111111111111111111111111
1111111111111111111111111111111111111111111111111111111111111111111111111111111111111111111111111111
1111111111111111111111111111111111111111111111111111111111111111111111111111111111111111111111111111
