1111111111111111111111111111111111111111111111111111111111111111111111111111111111111111111111111111
1111111111111111111111111111111111111111111111111111111111111111111111111111111111111111111111111111
1111000000000000000000000000000000000011111111111111111111111111111111111111111111111111111111111111
1111000000000000000000000000000000000011111111111111111111111111111111111111111111111111111111111111
1111000001111111111111111111111111110011111111111111111111111111111111111111111111111111111111111111
1111000001111111111111111111111111110011111111111111111111111111100000000011111111111111111111111111
1111000001111111111111111111111111110011111111111111111111111111100000000011111111111111111111111111
1111000001111111111111111111111111110011111111111111111111111111100000000011111111111111111111111111
1111111111111111111111111111111111110011111111111111111111111111100000000011111111111111111111111111
1111111111111111111111111111111111110011111111111111111111111111100000000011111111111111111111111111
1111111111111111111111111111100000000000000001111111111111111111100000000011111111111111111111111111
1111111111111111111111111111100000000000000001111111111111111111100000000011111111111111111111111111
1111111111111111111111111111100000000000000001111111111111111111100000000011111111111111111111111111
1111111111111111111111111111100000000000000001111111111111111111100000000011111111111111111111111111
1111111111111111111111111111100000000000000001111111111111111111100000000011111111111111111111111111
1111111111111111111111111111100000000000000001111111111111111111100000000011111111111111111111111111
1111111111111111111111111111100000000000000001111111111111111111100000000011111111111111111111111111
1111111110000000000000000000000000000000000000000000000000000011111110011111111111111111111111111111
1111111110000000000000000000000000000000000000000000000000000011111110011111111111111111111111111111
1111111110011111111111111111100000000000000001111111111111110011111110011111111111111111111111111111
1111111110011111111111111111100000000000000001111111111111110011111110011111111111111111111111111111
1111111110011111111111111111100000000000000001111111111111110011111110011111111111111111111111111111
1111111110011111111111111111100000000000000001111111111111110011111110011111111111111111111111111111
1111111110011111111111111111100000000000000001111111111111110011111110011111111111111111111111111111
1111111110011111111111111111111111111111111111111111111111110011111110011111111111111111111111111111
1111111110011111111111111111111111111111111111111111111111110011111110011111111111111111111111111111
1111111110011111111111111111111111111111111111111111111100000000011110011111111111111111111111111111
1111100000000000011111111111111111111111111111111111111100000000011110011111111111111111111111111111
1111100000000000011111111111111111111111111111111111111100000000011110011111111111111111111111111111
1111100000000000011111111111111111111111111111111111111100000000011110011111111111111111111111111111
1111100000000000011111111111111111111111111111111111111100000000011110011111111111111111111111111111
1111100000000000011110000000011111111100000000000011111100000000011110011111111111111111111111111111
1111100000000000011110000000011111111100000000000011111100000000011110011111111111111111111111111111
1111100000000000011110000000011111111100000000000011111100000000011110011111111111111111111111111111
1111100000000000011110000000011111111100000000000011111100000000011110011111111111111111111111111111
1111100000000000000000000000000000000000000000000000000000000000000000011111111111111111111111111111
1111100000000000000000000000000000000000000000000000000000000000000000011111111111111111111111111111
1111100000000000011110000000011111100100000000000011111100000000011110011111111111111111111111111111
1111100000000000011110000000011111100100000000000011111111110011111110011111111111111111111111111111
1111100000000000011110000000011111100100000000000011111111110011111110011111111111111111111111111111
1111100000000000011111111111111111100100000000000011111111110011111110011111111111111111111111111111
1111100000000000011111111111111111100100000000000011111111110011111110011111111111111111111111111111
1111100000000000011111111111111111100100000000000011111111110011111110011111111111111111111111111111
1111111110000111111111111111111111100100000000000011111111110011111110011111111111111111111111111111
1111111110000111111111111111111111100100000000000011111111110011111110011111111111111111111111111111
1111111110000111111111111111111111100111111100111111111111110011111110011111111111111111111111111111
1111111110000111111111111111111111100111111100111111111111110011111110011111111111111111111111111111
1111111110000111111111111111111111100111111100111111111111110011111110011111111111111111111111111111
1111111110000111111111111111111111100111111100111111111111110011111110011111111111111111111111111111
1111111110000111111111111111111111100111111100111111111111110011111110011111111111111111111111111111
1111111110000111111111111111111111100111111100111111111111110011111110011111111111111111111111111111
1111111110000111111111111111111111100111111100111111111111110011111110011111111111111111111111111111
1111111110000111111111111111111111100111111100111111111111110011111110011111111111111111111111111111
1111111110000111111111111111111000000000001100111111111111110011111110011111111111111111111111111111
1111111110000111111111111111111000000000001100111111111111110011111110011111111111111111111111111111
1111111110000111111111111111111000000000001100111111111111110011111100000000000011111111111111111111
1100000000000111111111111111111000000000001100111111111111110011111100000000000011111111111111111111
1100000000000000000000000000000000000000001100111111111111110011111100000000000011111111111111111111
1100000000000000000000000000000000000000001100111111111111110011111100000000000011111111111111111111
1100000000000111111111111111111000000000001100111111111111110011111100000000000011111111111111111111
1100000000000111111111111111111000000000001100111111111111110000000000000000000011111111111111111111
1100000000000111111111111111111111100011111100111111111111110000000000000000000011111111111111111111
1100000000000000000000000000000000000000000000111111111111111111111100000000000011111111111111111111
1100000000000000000000000000000000000000000000111111111111111111111100000000000011111111111111111111
1100000000000111111111111111100000000000011100111111111111111111111100000000000011111111111111111111
1100000000000111111111111111100000000000011100111111111111111111111110011100111111111111111111111111
1100000000000111111111111111100000000000011100111111111111111111111110011100111111111111111111111111
1100000000000111111111111111100000000000011100111111111111111111111110011100111111111111111111111111
1100000000000111111111111111100000000000011100111111111111111111111110011100111111111111111111111111
1111111000011111111111111111100000000000011100111111111111111111111110011100111111111111111111111111
1111111000011111111111111111100000000000011100111111111111111111111110011100111111111111111111111111
1111111000011111111111111111100000000000011100111111111100000000000010011100111111111111111111111111
1111111000011111111111111111100000000000011100111111111100000000000010011100000000000000000111111111
1111111000011111111111111111100000000000011100111111111100000000000010011100000000000000000111111111
1111111000011111111111111111111111110011111100111111111100000000000010011100000000000000000111111111
1111111000011111111111111111111111110011111100000000000000000000000010011100000000000000000111111111
1111111000011111111111111111111111110011111100000000000000000000000010011100000000000000000111111111
1111111000011111111111111111111111110000000000000011111100000000000010011100000000000000000111111111
1111111000011111111111111111111111110000000000000011111100000000000010011100000000000000000111111111
1111111000011111111111111111111111110000000000000011111100000000000000000000000000000000000111111111
1111111000011111111111111111111111110000000000000011111111111100000000000000000000000000000111111111
1111111000000000000000000000000000000000000000000011111111111111111110011111000000000000000111111111
1111111000000000000000000000000000000000000000000011111111111111111110011111000000000000000111111111
1111111110011111111111111111111111111000000000000011111111111111111110011111000000000000000111111111
1111111110011111111111111111111111111000000000000011111111111111111110011111000000000000000111111111
1111111110011111111111111111111111111111111111111111111111111111111110011111000000000000000111111111
1111111110011111111111111111111111111111111111111111111111111111111110011111000000000000000111111111
1000000000000000011111111111111111111111111111111111111111111111111110011111111111111111111111111111
1000000000000000011111111111111111111111111111111111111111111111111110011111111111111111111111111111
1000000000000000011111111111111111111111111111111111111111111111111110011111111111111111111111111111
1000000000000000011111111111111111111111111111111111111111111111111110011111111111111111111111111111
1000000000000000011111111111111111111111111111111111111111111111111110011111111111111111111111111111
1000000000000000000000000000000000000000000000000000000000000000000000011111111111111111111111111111
1000000000000000000000000000000000000000000000000000000000000000000000111111111111111111111111111111
1000000000000000011111111111111111111111111111111111111111111111111111111111111111111111111111111111
1000000000000000011111111111111111111111111111111111111111111111111111111111111111111111111111111111
1000000000000000011111111111111111111111111111111111111111111111111111111111111111111111111111111111
1000000000000000011111111111111111111111111111111111111111111111111111111111111111111111111111111111
1111111111111111111111111111111111111111111111111111111111111111111111111111111111111111111111111111
1111111111111111111111111111111111111111111111111111111111111111111111111111111111111111111111111111
